WWWWW  T   S   T   TTTW2
WS  W  T       T   TVTW 
W   W  T   TTTTT   TTTW 
WWBWW      T          W 
W   W    TTT  T   L   Wb
W TTW         T       W 
W   W  TT     T WWWWWWW 
WTT W           W     W 
W   WWWWWWWWAWWWW  WW W 
                W  W WW 
    W  TT   TT  W  WW W 
 3  W  T  L  T  W  W WW 
    W  T     T  W  WW W 
    WWWWW   WWWWW  W WW 
                   WW W 
WWW WWWWWWWWWWWWW  W WW1
W0       W         WW WW
WWWWWWWWWW WWWWWWWWWa  W
          P        WWWWW