                         
WWWWWWWWWWWWWWWWWWWWWWWWW
WP    aW V   TT   T     T
WWWWAWWWWWWT TT T   T   T
W1W  W  WTTT TT TTTTT   T
W   W   WTTT    T   T  TT
WWW WWW WWWWWW  T 0 T   T
W     W      W  T   T   T
WWW WWWWWWWW W  TTTTTTW T
W   W        W        W T
W WWWWWW WWWWWTTTTTTT W T
W W5W        W        W T
W W W WWWWWWWW  TTTTTTW T
W W W W W W  W          T
W W    W W  4WTTTTTTTT  T
W W WWWWWWWWWW   W   W  T
WbW   W      B W   W    T
WWW 2 W  3   WTTTTTTTTTTT
  WWWWWWWWWWWW           