WWWWWWWWWWWWWWWWWWWWWWWWWWWWWWW
WPWV    W4      W   W       W3W
W WWW W WWWWW WWW W W WTWWW W W
W   WTW       W   W   W   W W W
WWW W WWW WWWWW WWWWWWWWW W W W
W0W W   W W     W   W     W W W
W W W W WWW WWWWW W W WWWWW W W
W W W W   W       W W   W   W W
W W W WWW WWW WWWWWWWWW W WWW W
W W W  5W     W       W W     W
W W WWWWWWWWWWW WWWWW W WWWWWWW
W W W     W   W W   W   W     W
W W W WWW W W W W W WWWWW WWW W
W   W   W W W W   W W     W W W
W WWWWW W W W WWWWW W WWWWW W W
W   W   W   W   W   W W     W W
WWW W WWWWWWWWW W WWW W W WWW W
W1W   W     W   W       W W   W
W WWWWW W WWW WWWWWWWWWWWWW W W
W       W                   W2W
WWWWWWWWWWWWWWWWWWWWWWWWWWWWWWW