                       
           V           
        WWWWWWW        
                       
   WW                  
    WW     W           
     W   WWW     W     
         W       W     
     W     W     W     
     W   WWW     W     
    WW     W  W        
           W  WWWW     
        WWWW           
           P  W        
    W         WW       
    WW         W       
     WW       WW       
                       