                           
 0     3  WWWWWWWWWWWWWWWWW
 WWWWWWWWWW  2  W   W W4  W
 W1       W  WWWWW  W WWW W
 W   WWW  W  W      W   W W
 W  VW    W     WW  WWW W W
 WWWWW  WWWWWWWWW   W   W W
WW       W      W  WW WWW W
W  WWWWWWWWW   WW  W      W
W  W     W WW   W  WWWW W W
W    WWW W         W    W W
WWWWWW     WWWWWW  WW WWW W
W          W            W W
WWWWWWWWWWWWWWWWWWWWWWWWW W
W5W P W    W W W   W  W   W
W   W   W   W W       W W W
WWWWWWWWWWWWWWWW  WWWWWWW W
                   W       
  WWWW WWWWW WWWWWWWWWWW   
     WWW   WWW             
                           