                           
W WWWWWWWWWWW WWWWWWWWWWWWW
W W         WVW         W W
W WWWWW WWW WWW WWWWW W W W
W     W W   W   W     W W W
WWWWW W W WWWWWWW WWWWW W W
W   W   W   W     W   W W W
W W WWWWWWW W WWWWWWW W W W
W W       W W       W W   W
WWW WWWWW W WWW WWW W WWW W
W   W     W   W W W W   W W
W WWWWWWW WWW W W W W W W W
W W     W W   W   W W W W W
W W WWW W W WWWWWWW WWW W W
W W W W W W W       W   W W
W W W W WWW W WWWWWWW WWW W
W W W W   W W       W W   W
W W W WWW W WWWWWWW W W WWW
W       W           W     W
WWWWWWWWWWWWWW   WWWWWWWWWW
               P           